    +---+---+---+---+---+---+---+---+
    | 1 | 2 | 3 | 4 | 5 | 6 | 7 | 8 |
+---+---+---+---+---+---+---+---+---+
| 1 |<T>|<C>|<A>|<Q>|<K>|<A>|<C>|<T>|
+---+---+---+---+---+---+---+---+---+
| 2 |<O>|<O>|<O>|<O>|<O>|<O>|<O>|<O>|
+---+---+---+---+---+---+---+---+---+
| 3 |   |   |   |   |   |   |   |   |
+---+---+---+---+---+---+---+---+---+
| 4 |   |   |   |   |   |   |   |   |
+---+---+---+---+---+---+---+---+---+
| 5 |   |   |   |   |   |   |   |   |
+---+---+---+---+---+---+---+---+---+
| 6 |   |   |   |   |   |   |   |   |
+---+---+---+---+---+---+---+---+---+
| 7 |-O-|-O-|-O-|-O-|-O-|-O-|-O-|-O-|
+---+---+---+---+---+---+---+---+---+
| 8 |-T-|-C-|-A-|-Q-|-K-|-A-|-C-|-T-|
+---+---+---+---+---+---+---+---+---+
=================================================
    +---+---+---+---+---+---+---+---+
    | 1 | 2 | 3 | 4 | 5 | 6 | 7 | 8 |
+---+---+---+---+---+---+---+---+---+
| 1 |<T>|<C>|<A>|<Q>|<K>|<A>|<C>|<T>|
+---+---+---+---+---+---+---+---+---+
| 2 |<O>|<O>|<O>|<O>|<O>|<O>|<O>|<O>|
+---+---+---+---+---+---+---+---+---+
| 3 |   |   |   |   |   |   |   |   |
+---+---+---+---+---+---+---+---+---+
| 4 |   |   |   |   |   |   |   |   |
+---+---+---+---+---+---+---+---+---+
| 5 |   |   |   |   |   |   |   |   |
+---+---+---+---+---+---+---+---+---+
| 6 |   |-O-|   |   |   |   |   |   |
+---+---+---+---+---+---+---+---+---+
| 7 |-O-|   |-O-|-O-|-O-|-O-|-O-|-O-|
+---+---+---+---+---+---+---+---+---+
| 8 |-T-|-C-|-A-|-Q-|-K-|-A-|-C-|-T-|
+---+---+---+---+---+---+---+---+---+
=================================================
Milisec: 803
Te toca mover.
2
5
4
5
    +---+---+---+---+---+---+---+---+
    | 1 | 2 | 3 | 4 | 5 | 6 | 7 | 8 |
+---+---+---+---+---+---+---+---+---+
| 1 |<T>|<C>|<A>|<Q>|<K>|<A>|<C>|<T>|
+---+---+---+---+---+---+---+---+---+
| 2 |<O>|<O>|<O>|<O>|   |<O>|<O>|<O>|
+---+---+---+---+---+---+---+---+---+
| 3 |   |   |   |   |   |   |   |   |
+---+---+---+---+---+---+---+---+---+
| 4 |   |   |   |   |<O>|   |   |   |
+---+---+---+---+---+---+---+---+---+
| 5 |   |   |   |   |   |   |   |   |
+---+---+---+---+---+---+---+---+---+
| 6 |   |-O-|   |   |   |   |   |   |
+---+---+---+---+---+---+---+---+---+
| 7 |-O-|   |-O-|-O-|-O-|-O-|-O-|-O-|
+---+---+---+---+---+---+---+---+---+
| 8 |-T-|-C-|-A-|-Q-|-K-|-A-|-C-|-T-|
+---+---+---+---+---+---+---+---+---+
=================================================
    +---+---+---+---+---+---+---+---+
    | 1 | 2 | 3 | 4 | 5 | 6 | 7 | 8 |
+---+---+---+---+---+---+---+---+---+
| 1 |<T>|<C>|<A>|<Q>|<K>|<A>|<C>|<T>|
+---+---+---+---+---+---+---+---+---+
| 2 |<O>|<O>|<O>|<O>|   |<O>|<O>|<O>|
+---+---+---+---+---+---+---+---+---+
| 3 |   |   |   |   |   |   |   |   |
+---+---+---+---+---+---+---+---+---+
| 4 |   |   |   |   |<O>|   |   |   |
+---+---+---+---+---+---+---+---+---+
| 5 |   |   |   |   |   |   |   |   |
+---+---+---+---+---+---+---+---+---+
| 6 |-O-|-O-|   |   |   |   |   |   |
+---+---+---+---+---+---+---+---+---+
| 7 |   |   |-O-|-O-|-O-|-O-|-O-|-O-|
+---+---+---+---+---+---+---+---+---+
| 8 |-T-|-C-|-A-|-Q-|-K-|-A-|-C-|-T-|
+---+---+---+---+---+---+---+---+---+
=================================================
Milisec: 639
Te toca mover.
2
4
4
4
    +---+---+---+---+---+---+---+---+
    | 1 | 2 | 3 | 4 | 5 | 6 | 7 | 8 |
+---+---+---+---+---+---+---+---+---+
| 1 |<T>|<C>|<A>|<Q>|<K>|<A>|<C>|<T>|
+---+---+---+---+---+---+---+---+---+
| 2 |<O>|<O>|<O>|   |   |<O>|<O>|<O>|
+---+---+---+---+---+---+---+---+---+
| 3 |   |   |   |   |   |   |   |   |
+---+---+---+---+---+---+---+---+---+
| 4 |   |   |   |<O>|<O>|   |   |   |
+---+---+---+---+---+---+---+---+---+
| 5 |   |   |   |   |   |   |   |   |
+---+---+---+---+---+---+---+---+---+
| 6 |-O-|-O-|   |   |   |   |   |   |
+---+---+---+---+---+---+---+---+---+
| 7 |   |   |-O-|-O-|-O-|-O-|-O-|-O-|
+---+---+---+---+---+---+---+---+---+
| 8 |-T-|-C-|-A-|-Q-|-K-|-A-|-C-|-T-|
+---+---+---+---+---+---+---+---+---+
=================================================
    +---+---+---+---+---+---+---+---+
    | 1 | 2 | 3 | 4 | 5 | 6 | 7 | 8 |
+---+---+---+---+---+---+---+---+---+
| 1 |<T>|<C>|<A>|<Q>|<K>|<A>|<C>|<T>|
+---+---+---+---+---+---+---+---+---+
| 2 |<O>|<O>|<O>|   |   |<O>|<O>|<O>|
+---+---+---+---+---+---+---+---+---+
| 3 |   |   |   |   |   |   |   |   |
+---+---+---+---+---+---+---+---+---+
| 4 |   |   |   |<O>|<O>|   |   |   |
+---+---+---+---+---+---+---+---+---+
| 5 |   |   |   |   |   |   |   |   |
+---+---+---+---+---+---+---+---+---+
| 6 |-O-|-O-|   |-O-|   |   |   |   |
+---+---+---+---+---+---+---+---+---+
| 7 |   |   |-O-|   |-O-|-O-|-O-|-O-|
+---+---+---+---+---+---+---+---+---+
| 8 |-T-|-C-|-A-|-Q-|-K-|-A-|-C-|-T-|
+---+---+---+---+---+---+---+---+---+
=================================================
Milisec: 1492
Te toca mover.
1
2
3
3
    +---+---+---+---+---+---+---+---+
    | 1 | 2 | 3 | 4 | 5 | 6 | 7 | 8 |
+---+---+---+---+---+---+---+---+---+
| 1 |<T>|   |<A>|<Q>|<K>|<A>|<C>|<T>|
+---+---+---+---+---+---+---+---+---+
| 2 |<O>|<O>|<O>|   |   |<O>|<O>|<O>|
+---+---+---+---+---+---+---+---+---+
| 3 |   |   |<C>|   |   |   |   |   |
+---+---+---+---+---+---+---+---+---+
| 4 |   |   |   |<O>|<O>|   |   |   |
+---+---+---+---+---+---+---+---+---+
| 5 |   |   |   |   |   |   |   |   |
+---+---+---+---+---+---+---+---+---+
| 6 |-O-|-O-|   |-O-|   |   |   |   |
+---+---+---+---+---+---+---+---+---+
| 7 |   |   |-O-|   |-O-|-O-|-O-|-O-|
+---+---+---+---+---+---+---+---+---+
| 8 |-T-|-C-|-A-|-Q-|-K-|-A-|-C-|-T-|
+---+---+---+---+---+---+---+---+---+
=================================================
    +---+---+---+---+---+---+---+---+
    | 1 | 2 | 3 | 4 | 5 | 6 | 7 | 8 |
+---+---+---+---+---+---+---+---+---+
| 1 |<T>|   |<A>|<Q>|<K>|<A>|<C>|<T>|
+---+---+---+---+---+---+---+---+---+
| 2 |<O>|<O>|<O>|   |   |<O>|<O>|<O>|
+---+---+---+---+---+---+---+---+---+
| 3 |   |   |<C>|   |   |   |   |   |
+---+---+---+---+---+---+---+---+---+
| 4 |   |   |   |<O>|<O>|   |   |   |
+---+---+---+---+---+---+---+---+---+
| 5 |   |   |   |   |   |   |   |   |
+---+---+---+---+---+---+---+---+---+
| 6 |-O-|-O-|   |-O-|-O-|   |   |   |
+---+---+---+---+---+---+---+---+---+
| 7 |   |   |-O-|   |   |-O-|-O-|-O-|
+---+---+---+---+---+---+---+---+---+
| 8 |-T-|-C-|-A-|-Q-|-K-|-A-|-C-|-T-|
+---+---+---+---+---+---+---+---+---+
=================================================
Milisec: 2330
Te toca mover.
2
7
3
7
    +---+---+---+---+---+---+---+---+
    | 1 | 2 | 3 | 4 | 5 | 6 | 7 | 8 |
+---+---+---+---+---+---+---+---+---+
| 1 |<T>|   |<A>|<Q>|<K>|<A>|<C>|<T>|
+---+---+---+---+---+---+---+---+---+
| 2 |<O>|<O>|<O>|   |   |<O>|   |<O>|
+---+---+---+---+---+---+---+---+---+
| 3 |   |   |<C>|   |   |   |<O>|   |
+---+---+---+---+---+---+---+---+---+
| 4 |   |   |   |<O>|<O>|   |   |   |
+---+---+---+---+---+---+---+---+---+
| 5 |   |   |   |   |   |   |   |   |
+---+---+---+---+---+---+---+---+---+
| 6 |-O-|-O-|   |-O-|-O-|   |   |   |
+---+---+---+---+---+---+---+---+---+
| 7 |   |   |-O-|   |   |-O-|-O-|-O-|
+---+---+---+---+---+---+---+---+---+
| 8 |-T-|-C-|-A-|-Q-|-K-|-A-|-C-|-T-|
+---+---+---+---+---+---+---+---+---+
=================================================
    +---+---+---+---+---+---+---+---+
    | 1 | 2 | 3 | 4 | 5 | 6 | 7 | 8 |
+---+---+---+---+---+---+---+---+---+
| 1 |<T>|   |<A>|<Q>|<K>|<A>|<C>|<T>|
+---+---+---+---+---+---+---+---+---+
| 2 |<O>|<O>|<O>|   |   |<O>|   |<O>|
+---+---+---+---+---+---+---+---+---+
| 3 |   |   |<C>|   |   |   |<O>|   |
+---+---+---+---+---+---+---+---+---+
| 4 |   |   |   |<O>|<O>|   |   |   |
+---+---+---+---+---+---+---+---+---+
| 5 |   |   |   |-O-|   |   |   |   |
+---+---+---+---+---+---+---+---+---+
| 6 |-O-|-O-|   |   |-O-|   |   |   |
+---+---+---+---+---+---+---+---+---+
| 7 |   |   |-O-|   |   |-O-|-O-|-O-|
+---+---+---+---+---+---+---+---+---+
| 8 |-T-|-C-|-A-|-Q-|-K-|-A-|-C-|-T-|
+---+---+---+---+---+---+---+---+---+
=================================================
Milisec: 1580
Te toca mover.
1
6
2
7
    +---+---+---+---+---+---+---+---+
    | 1 | 2 | 3 | 4 | 5 | 6 | 7 | 8 |
+---+---+---+---+---+---+---+---+---+
| 1 |<T>|   |<A>|<Q>|<K>|   |<C>|<T>|
+---+---+---+---+---+---+---+---+---+
| 2 |<O>|<O>|<O>|   |   |<O>|<A>|<O>|
+---+---+---+---+---+---+---+---+---+
| 3 |   |   |<C>|   |   |   |<O>|   |
+---+---+---+---+---+---+---+---+---+
| 4 |   |   |   |<O>|<O>|   |   |   |
+---+---+---+---+---+---+---+---+---+
| 5 |   |   |   |-O-|   |   |   |   |
+---+---+---+---+---+---+---+---+---+
| 6 |-O-|-O-|   |   |-O-|   |   |   |
+---+---+---+---+---+---+---+---+---+
| 7 |   |   |-O-|   |   |-O-|-O-|-O-|
+---+---+---+---+---+---+---+---+---+
| 8 |-T-|-C-|-A-|-Q-|-K-|-A-|-C-|-T-|
+---+---+---+---+---+---+---+---+---+
=================================================
    +---+---+---+---+---+---+---+---+
    | 1 | 2 | 3 | 4 | 5 | 6 | 7 | 8 |
+---+---+---+---+---+---+---+---+---+
| 1 |<T>|   |<A>|<Q>|<K>|   |<C>|<T>|
+---+---+---+---+---+---+---+---+---+
| 2 |<O>|<O>|<O>|   |   |<O>|<A>|<O>|
+---+---+---+---+---+---+---+---+---+
| 3 |   |   |<C>|   |   |   |<O>|   |
+---+---+---+---+---+---+---+---+---+
| 4 |   |-A-|   |<O>|<O>|   |   |   |
+---+---+---+---+---+---+---+---+---+
| 5 |   |   |   |-O-|   |   |   |   |
+---+---+---+---+---+---+---+---+---+
| 6 |-O-|-O-|   |   |-O-|   |   |   |
+---+---+---+---+---+---+---+---+---+
| 7 |   |   |-O-|   |   |-O-|-O-|-O-|
+---+---+---+---+---+---+---+---+---+
| 8 |-T-|-C-|-A-|-Q-|-K-|   |-C-|-T-|
+---+---+---+---+---+---+---+---+---+
=================================================
Milisec: 15985
Te toca mover.
1
3
2
4
    +---+---+---+---+---+---+---+---+
    | 1 | 2 | 3 | 4 | 5 | 6 | 7 | 8 |
+---+---+---+---+---+---+---+---+---+
| 1 |<T>|   |   |<Q>|<K>|   |<C>|<T>|
+---+---+---+---+---+---+---+---+---+
| 2 |<O>|<O>|<O>|<A>|   |<O>|<A>|<O>|
+---+---+---+---+---+---+---+---+---+
| 3 |   |   |<C>|   |   |   |<O>|   |
+---+---+---+---+---+---+---+---+---+
| 4 |   |-A-|   |<O>|<O>|   |   |   |
+---+---+---+---+---+---+---+---+---+
| 5 |   |   |   |-O-|   |   |   |   |
+---+---+---+---+---+---+---+---+---+
| 6 |-O-|-O-|   |   |-O-|   |   |   |
+---+---+---+---+---+---+---+---+---+
| 7 |   |   |-O-|   |   |-O-|-O-|-O-|
+---+---+---+---+---+---+---+---+---+
| 8 |-T-|-C-|-A-|-Q-|-K-|   |-C-|-T-|
+---+---+---+---+---+---+---+---+---+
=================================================
    +---+---+---+---+---+---+---+---+
    | 1 | 2 | 3 | 4 | 5 | 6 | 7 | 8 |
+---+---+---+---+---+---+---+---+---+
| 1 |<T>|   |   |<Q>|<K>|   |<C>|<T>|
+---+---+---+---+---+---+---+---+---+
| 2 |<O>|<O>|<O>|<A>|   |<O>|<A>|<O>|
+---+---+---+---+---+---+---+---+---+
| 3 |   |   |<C>|   |   |   |<O>|   |
+---+---+---+---+---+---+---+---+---+
| 4 |   |-A-|   |<O>|-O-|   |   |   |
+---+---+---+---+---+---+---+---+---+
| 5 |   |   |   |   |   |   |   |   |
+---+---+---+---+---+---+---+---+---+
| 6 |-O-|-O-|   |   |-O-|   |   |   |
+---+---+---+---+---+---+---+---+---+
| 7 |   |   |-O-|   |   |-O-|-O-|-O-|
+---+---+---+---+---+---+---+---+---+
| 8 |-T-|-C-|-A-|-Q-|-K-|   |-C-|-T-|
+---+---+---+---+---+---+---+---+---+
=================================================
Milisec: 49732
Te toca mover.
2
7
4
5
    +---+---+---+---+---+---+---+---+
    | 1 | 2 | 3 | 4 | 5 | 6 | 7 | 8 |
+---+---+---+---+---+---+---+---+---+
| 1 |<T>|   |   |<Q>|<K>|   |<C>|<T>|
+---+---+---+---+---+---+---+---+---+
| 2 |<O>|<O>|<O>|<A>|   |<O>|   |<O>|
+---+---+---+---+---+---+---+---+---+
| 3 |   |   |<C>|   |   |   |<O>|   |
+---+---+---+---+---+---+---+---+---+
| 4 |   |-A-|   |<O>|<A>|   |   |   |
+---+---+---+---+---+---+---+---+---+
| 5 |   |   |   |   |   |   |   |   |
+---+---+---+---+---+---+---+---+---+
| 6 |-O-|-O-|   |   |-O-|   |   |   |
+---+---+---+---+---+---+---+---+---+
| 7 |   |   |-O-|   |   |-O-|-O-|-O-|
+---+---+---+---+---+---+---+---+---+
| 8 |-T-|-C-|-A-|-Q-|-K-|   |-C-|-T-|
+---+---+---+---+---+---+---+---+---+
=================================================
Exception in thread "main" java.lang.OutOfMemoryError: Java heap space
	at java.util.Vector.<init>(Unknown Source)
	at java.util.Vector.<init>(Unknown Source)
	at java.util.Vector.<init>(Unknown Source)
	at sources.State.clone_board(State.java:1276)
	at sources.State.bishop_movement(State.java:448)
	at sources.State.next_states(State.java:212)
	at sources.State.getMinMax(State.java:1363)
	at sources.State.getMinMax(State.java:1348)
	at sources.State.getMinMax(State.java:1406)
	at sources.State.getMinMax(State.java:1434)
	at sources.State.getMinMax(State.java:1332)
	at sources.Pruebas.main(Pruebas.java:41)